Category,ProjectId,snapshot,CLOC,addedLOC,removedLOC
Full-stack Library,microsoft/Quantum,0,34258,29129,5129
Full-stack Library,microsoft/Quantum,1,3932,3672,260
Full-stack Library,microsoft/Quantum,2,4204,3701,503
Full-stack Library,microsoft/Quantum,3,2257978,2238084,19894
Full-stack Library,microsoft/Quantum,4,10697,6621,4076
Full-stack Library,microsoft/Quantum,5,10319,5906,4413
Full-stack Library,microsoft/Quantum,6,15372,9524,5848
Full-stack Library,microsoft/Quantum,7,3622,2824,798
Full-stack Library,microsoft/Quantum,8,6263,4098,2165
Full-stack Library,microsoft/Quantum,9,8559,3892,4667
Full-stack Library,microsoft/QuantumLibraries,0,34258,29129,5129
Full-stack Library,microsoft/QuantumLibraries,1,3932,3672,260
Full-stack Library,microsoft/QuantumLibraries,2,4204,3701,503
Full-stack Library,microsoft/QuantumLibraries,3,43506,18693,24813
Full-stack Library,microsoft/QuantumLibraries,4,3823,2469,1354
Full-stack Library,microsoft/QuantumLibraries,5,33450,23204,10246
Full-stack Library,microsoft/QuantumLibraries,6,6376,3732,2644
Full-stack Library,microsoft/QuantumLibraries,7,19217,12131,7086
Full-stack Library,microsoft/QuantumLibraries,8,2157,1505,652
Full-stack Library,microsoft/QuantumLibraries,9,9843,7731,2112
Full-stack Library,microsoft/Quantum-NC,0,1343,1176,167
Full-stack Library,microsoft/Quantum-NC,1,1794,1570,224
Full-stack Library,microsoft/Quantum-NC,2,336,181,155
Full-stack Library,microsoft/Quantum-NC,3,466,278,188
Full-stack Library,microsoft/Quantum-NC,4,557,258,299
Full-stack Library,microsoft/Quantum-NC,5,730,439,291
Full-stack Library,microsoft/Quantum-NC,6,3310,3193,117
Full-stack Library,microsoft/Quantum-NC,7,3,3,0
Full-stack Library,microsoft/Quantum-NC,8,36,23,13
Full-stack Library,microsoft/Quantum-NC,9,0,0,0
Compiler,microsoft/qsharp-compiler,0,68531,59687,8844
Compiler,microsoft/qsharp-compiler,1,21324,13593,7731
Compiler,microsoft/qsharp-compiler,2,24204,15367,8837
Compiler,microsoft/qsharp-compiler,3,16302,9717,6585
Compiler,microsoft/qsharp-compiler,4,50298,41303,8995
Compiler,microsoft/qsharp-compiler,5,12,6,6
Compiler,microsoft/qsharp-compiler,6,85,50,35
Compiler,microsoft/qsharp-compiler,7,1023,550,473
Compiler,microsoft/qsharp-compiler,8,22,12,10
Compiler,microsoft/qsharp-compiler,9,502,274,228
Cryptography,theQRL/QRL,0,6163,4459,1704
Cryptography,theQRL/QRL,1,11244,7433,3811
Cryptography,theQRL/QRL,2,17250,9292,7958
Cryptography,theQRL/QRL,3,599012,305600,293412
Cryptography,theQRL/QRL,4,82317,44850,37467
Cryptography,theQRL/QRL,5,40571,23512,17059
Cryptography,theQRL/QRL,6,41417,26869,14548
Cryptography,theQRL/QRL,7,5833,4842,991
Cryptography,theQRL/QRL,8,942,685,257
Cryptography,theQRL/QRL,9,589,381,208
Full-stack Library,rigetti/pyquil,0,10855,9902,953
Full-stack Library,rigetti/pyquil,1,5904,3617,2287
Full-stack Library,rigetti/pyquil,2,2525,1522,1003
Full-stack Library,rigetti/pyquil,3,30781,21227,9554
Full-stack Library,rigetti/pyquil,4,12959,8885,4074
Full-stack Library,rigetti/pyquil,5,14097,6509,7588
Full-stack Library,rigetti/pyquil,6,16447,10882,5565
Full-stack Library,rigetti/pyquil,7,16897,11280,5617
Full-stack Library,rigetti/pyquil,8,11454,8864,2590
Full-stack Library,rigetti/pyquil,9,5079,2962,2117
Quantum-Chemistry,ValeevGroup/mpqc,0,415551,324326,91225
Quantum-Chemistry,ValeevGroup/mpqc,1,19941,13345,6596
Quantum-Chemistry,ValeevGroup/mpqc,2,29247,14135,15112
Quantum-Chemistry,ValeevGroup/mpqc,3,23598,14160,9438
Quantum-Chemistry,ValeevGroup/mpqc,4,29721,22357,7364
Quantum-Chemistry,ValeevGroup/mpqc,5,17445,13952,3493
Quantum-Chemistry,ValeevGroup/mpqc,6,28693,21186,7507
Quantum-Chemistry,ValeevGroup/mpqc,7,57571,45829,11742
Quantum-Chemistry,ValeevGroup/mpqc,8,57840,41275,16565
Quantum-Chemistry,ValeevGroup/mpqc,9,181443,152793,28650
Quantum-Chemistry,pyscf/pyscf,0,176200,156927,19273
Quantum-Chemistry,pyscf/pyscf,1,270708,124417,146291
Quantum-Chemistry,pyscf/pyscf,2,71489,47579,23910
Quantum-Chemistry,pyscf/pyscf,3,34998,24082,10916
Quantum-Chemistry,pyscf/pyscf,4,26060,18421,7639
Quantum-Chemistry,pyscf/pyscf,5,124170,108679,15491
Quantum-Chemistry,pyscf/pyscf,6,40381,28750,11631
Quantum-Chemistry,pyscf/pyscf,7,37902,24653,13249
Quantum-Chemistry,pyscf/pyscf,8,56091,41924,14167
Quantum-Chemistry,pyscf/pyscf,9,48414,40288,8126
Full-stack Library,Qiskit/qiskit-terra,0,118070,84949,33121
Full-stack Library,Qiskit/qiskit-terra,1,266966,128860,138106
Full-stack Library,Qiskit/qiskit-terra,2,21239,13295,7944
Full-stack Library,Qiskit/qiskit-terra,3,78362,65326,13036
Full-stack Library,Qiskit/qiskit-terra,4,44803,29018,15785
Full-stack Library,Qiskit/qiskit-terra,5,86041,58830,27211
Full-stack Library,Qiskit/qiskit-terra,6,165171,82981,82190
Full-stack Library,Qiskit/qiskit-terra,7,111982,29585,82397
Full-stack Library,Qiskit/qiskit-terra,8,86154,55694,30460
Full-stack Library,Qiskit/qiskit-terra,9,36505,25327,11178
ToolKit,evaleev/libint,0,41307,35398,5909
ToolKit,evaleev/libint,1,206,187,19
ToolKit,evaleev/libint,2,212,121,91
ToolKit,evaleev/libint,3,7909,6139,1770
ToolKit,evaleev/libint,4,9549,7389,2160
ToolKit,evaleev/libint,5,20444,12848,7596
ToolKit,evaleev/libint,6,1615,1071,544
ToolKit,evaleev/libint,7,14436,3091,11345
ToolKit,evaleev/libint,8,1810,1658,152
ToolKit,evaleev/libint,9,3919,2543,1376
Quantum-Chemistry,MolSSI-BSE/basis_set_exchange,0,842460,430540,411920
Quantum-Chemistry,MolSSI-BSE/basis_set_exchange,1,927842,753970,173872
Quantum-Chemistry,MolSSI-BSE/basis_set_exchange,2,100190,68924,31266
Quantum-Chemistry,MolSSI-BSE/basis_set_exchange,3,1154212,717719,436493
Quantum-Chemistry,MolSSI-BSE/basis_set_exchange,4,8461566,4985091,3476475
Quantum-Chemistry,MolSSI-BSE/basis_set_exchange,5,2064807,1886986,177821
Quantum-Chemistry,MolSSI-BSE/basis_set_exchange,6,956095,849703,106392
Quantum-Chemistry,MolSSI-BSE/basis_set_exchange,7,1213095,1184957,28138
Quantum-Chemistry,MolSSI-BSE/basis_set_exchange,8,469890,460038,9852
Quantum-Chemistry,MolSSI-BSE/basis_set_exchange,9,2189327,2138382,50945
Full-stack Library,Qiskit/qiskit,0,34843,29391,5452
Full-stack Library,Qiskit/qiskit,1,8289,5728,2561
Full-stack Library,Qiskit/qiskit,2,29612,8273,21339
Full-stack Library,Qiskit/qiskit,3,6044,4016,2028
Full-stack Library,Qiskit/qiskit,4,30835,29485,1350
Full-stack Library,Qiskit/qiskit,5,35542,5269,30273
Full-stack Library,Qiskit/qiskit,6,2732,2283,449
Full-stack Library,Qiskit/qiskit,7,67,63,4
Full-stack Library,Qiskit/qiskit,8,76,76,0
Full-stack Library,Qiskit/qiskit,9,24,23,1
Quantum Algorithsm,mabuchilab/QNET,0,15015,13695,1320
Quantum Algorithsm,mabuchilab/QNET,1,29687,16137,13550
Quantum Algorithsm,mabuchilab/QNET,2,26007,15599,10408
Quantum Algorithsm,mabuchilab/QNET,3,51335,45759,5576
Quantum Algorithsm,mabuchilab/QNET,4,52,41,11
Quantum Algorithsm,mabuchilab/QNET,5,898,892,6
Quantum Algorithsm,mabuchilab/QNET,6,3011,2673,338
Quantum Algorithsm,mabuchilab/QNET,7,457,380,77
Quantum Algorithsm,mabuchilab/QNET,8,46705,9401,37304
Quantum Algorithsm,mabuchilab/QNET,9,1709,922,787
Quantum-Chemistry,MolSSI/QCElemental,0,71480,53408,18072
Quantum-Chemistry,MolSSI/QCElemental,1,9258,6113,3145
Quantum-Chemistry,MolSSI/QCElemental,2,7738,6040,1698
Quantum-Chemistry,MolSSI/QCElemental,3,8656,5269,3387
Quantum-Chemistry,MolSSI/QCElemental,4,15527,8847,6680
Quantum-Chemistry,MolSSI/QCElemental,5,312829,265652,47177
Quantum-Chemistry,MolSSI/QCElemental,6,469,370,99
Quantum-Chemistry,MolSSI/QCElemental,7,184,178,6
Quantum-Chemistry,MolSSI/QCElemental,8,0,0,0
Quantum-Chemistry,MolSSI/QCElemental,9,5,3,2
Experimentation,m-labs/artiq,0,8919,6871,2048
Experimentation,m-labs/artiq,1,21981,14379,7602
Experimentation,m-labs/artiq,2,14125,9658,4467
Experimentation,m-labs/artiq,3,22084,14945,7139
Experimentation,m-labs/artiq,4,40849,26226,14623
Experimentation,m-labs/artiq,5,17414,12161,5253
Experimentation,m-labs/artiq,6,22221,12703,9518
Experimentation,m-labs/artiq,7,25931,16975,8956
Experimentation,m-labs/artiq,8,6009,3991,2018
Experimentation,m-labs/artiq,9,30361,20513,9848
Simulator,rigetti/qvm,0,26783,25838,945
Simulator,rigetti/qvm,1,2228,1577,651
Simulator,rigetti/qvm,2,16475,11138,5337
Simulator,rigetti/qvm,3,5842,3455,2387
Simulator,rigetti/qvm,4,10,5,5
Simulator,rigetti/qvm,5,2,1,1
Simulator,rigetti/qvm,6,5,4,1
Simulator,rigetti/qvm,7,2,1,1
Simulator,rigetti/qvm,8,15,15,0
Simulator,rigetti/qvm,9,10,5,5
Simulator,softwareQinc/qpp,0,47984,26521,21463
Simulator,softwareQinc/qpp,1,1743,902,841
Simulator,softwareQinc/qpp,2,887649,462322,425327
Simulator,softwareQinc/qpp,3,114108,57475,56633
Simulator,softwareQinc/qpp,4,50517,29413,21104
Simulator,softwareQinc/qpp,5,75279,40460,34819
Simulator,softwareQinc/qpp,6,182,84,98
Simulator,softwareQinc/qpp,7,638714,404219,234495
Simulator,softwareQinc/qpp,8,20916,10710,10206
Simulator,softwareQinc/qpp,9,247,175,72
Cryptography,supernomad/quantum,0,1112,777,335
Quantum-Chemistry,MolSSI/QCEngine,0,4485,4058,427
Quantum-Chemistry,MolSSI/QCEngine,1,1806,1224,582
Quantum-Chemistry,MolSSI/QCEngine,2,1584,1255,329
Quantum-Chemistry,MolSSI/QCEngine,3,14134,9209,4925
Quantum-Chemistry,MolSSI/QCEngine,4,7923,5061,2862
Quantum-Chemistry,MolSSI/QCEngine,5,7363,5374,1989
Quantum-Chemistry,MolSSI/QCEngine,6,17715,11024,6691
Quantum-Chemistry,MolSSI/QCEngine,7,7894,5707,2187
Quantum-Chemistry,MolSSI/QCEngine,8,4656,3890,766
Quantum-Chemistry,MolSSI/QCEngine,9,64,64,0
Simulator,marvel-nccr/quantum-mobile,0,10332,6634,3698
Simulator,marvel-nccr/quantum-mobile,1,2196,1857,339
Simulator,marvel-nccr/quantum-mobile,2,6679,2362,4317
Simulator,marvel-nccr/quantum-mobile,3,1790,1669,121
Simulator,marvel-nccr/quantum-mobile,4,75,51,24
Simulator,marvel-nccr/quantum-mobile,5,2081,147,1934
Simulator,marvel-nccr/quantum-mobile,6,75,50,25
Simulator,marvel-nccr/quantum-mobile,7,163,81,82
Simulator,marvel-nccr/quantum-mobile,8,3765,3714,51
Simulator,marvel-nccr/quantum-mobile,9,39,21,18
Simulator,QuantumBFS/YaoBlocks.jl,0,20585,13166,7419
Simulator,QuantumBFS/YaoBlocks.jl,1,1229,730,499
Simulator,QuantumBFS/YaoBlocks.jl,2,5413,3535,1878
Simulator,QuantumBFS/YaoBlocks.jl,3,5559,3195,2364
Simulator,QuantumBFS/YaoBlocks.jl,4,118,84,34
Simulator,QuantumBFS/YaoBlocks.jl,5,6,3,3
Simulator,QuantumBFS/YaoBlocks.jl,6,2,1,1
Simulator,QuantumBFS/YaoBlocks.jl,7,234,118,116
Simulator,QuantumBFS/YaoBlocks.jl,8,2,1,1
Simulator,QuantumBFS/YaoBlocks.jl,9,2,1,1
ToolKit,qojulia/QuantumOptics.jl,0,8817,5906,2911
ToolKit,qojulia/QuantumOptics.jl,1,1008,490,518
ToolKit,qojulia/QuantumOptics.jl,2,497,391,106
ToolKit,qojulia/QuantumOptics.jl,3,6518,5133,1385
ToolKit,qojulia/QuantumOptics.jl,4,2579,2190,389
ToolKit,qojulia/QuantumOptics.jl,5,8258,5122,3136
ToolKit,qojulia/QuantumOptics.jl,6,348,264,84
ToolKit,qojulia/QuantumOptics.jl,7,5385,3617,1768
ToolKit,qojulia/QuantumOptics.jl,8,32437,15867,16570
ToolKit,qojulia/QuantumOptics.jl,9,5591,1562,4029
Quantum-Chemistry,MolSSI/QCFractal,0,181466,128345,53121
Quantum-Chemistry,MolSSI/QCFractal,1,3393,2258,1135
Quantum-Chemistry,MolSSI/QCFractal,2,2385,1057,1328
Quantum-Chemistry,MolSSI/QCFractal,3,86026,8841,77185
Quantum-Chemistry,MolSSI/QCFractal,4,13509,8936,4573
Quantum-Chemistry,MolSSI/QCFractal,5,17368,11952,5416
Quantum-Chemistry,MolSSI/QCFractal,6,30895,16509,14386
Quantum-Chemistry,MolSSI/QCFractal,7,31480,22915,8565
Quantum-Chemistry,MolSSI/QCFractal,8,25362,14173,11189
Quantum-Chemistry,MolSSI/QCFractal,9,54376,40949,13427
Full-stack Library,Qiskit/qiskit-ibmq-provider,0,12709,9517,3192
Full-stack Library,Qiskit/qiskit-ibmq-provider,1,11009,8160,2849
Full-stack Library,Qiskit/qiskit-ibmq-provider,2,6314,2806,3508
Full-stack Library,Qiskit/qiskit-ibmq-provider,3,11133,7140,3993
Full-stack Library,Qiskit/qiskit-ibmq-provider,4,14997,11960,3037
Full-stack Library,Qiskit/qiskit-ibmq-provider,5,7223,4012,3211
Full-stack Library,Qiskit/qiskit-ibmq-provider,6,18,1,17
Full-stack Library,Qiskit/qiskit-ibmq-provider,7,11,9,2
Full-stack Library,Qiskit/qiskit-ibmq-provider,8,76,41,35
Full-stack Library,Qiskit/qiskit-ibmq-provider,9,53,46,7
Full-stack Library,qiskit-community/qiskit-js,0,226865,222362,4503
Full-stack Library,qiskit-community/qiskit-js,1,28655,14040,14615
Full-stack Library,qiskit-community/qiskit-js,2,13309,3472,9837
Full-stack Library,qiskit-community/qiskit-js,3,592796,195524,397272
Full-stack Library,qiskit-community/qiskit-js,4,11461,11229,232
Full-stack Library,qiskit-community/qiskit-js,5,5738,2572,3166
Full-stack Library,qiskit-community/qiskit-js,6,32756,19347,13409
Full-stack Library,qiskit-community/qiskit-js,7,139,139,0
Full-stack Library,qiskit-community/qiskit-js,8,0,0,0
Full-stack Library,qiskit-community/qiskit-js,9,11,3,8
Quantum Algorithsm,Qiskit/qiskit-aqua,0,144826,98620,46206
Quantum Algorithsm,Qiskit/qiskit-aqua,1,1943797,944938,998859
Quantum Algorithsm,Qiskit/qiskit-aqua,2,359214,178274,180940
Quantum Algorithsm,Qiskit/qiskit-aqua,3,53700,30051,23649
Quantum Algorithsm,Qiskit/qiskit-aqua,4,47221,26743,20478
Quantum Algorithsm,Qiskit/qiskit-aqua,5,85654,47396,38258
Quantum Algorithsm,Qiskit/qiskit-aqua,6,44963,20757,24206
Quantum Algorithsm,Qiskit/qiskit-aqua,7,38951,30124,8827
Quantum Algorithsm,Qiskit/qiskit-aqua,8,16400,8522,7878
Quantum Algorithsm,Qiskit/qiskit-aqua,9,224,175,49
Full-stack Library,qiskit-community/qiskit-vscode,0,227198,137071,90127
Full-stack Library,qiskit-community/qiskit-vscode,1,114676,64381,50295
Full-stack Library,qiskit-community/qiskit-vscode,2,19932,8106,11826
Full-stack Library,qiskit-community/qiskit-vscode,3,32751,17425,15326
Full-stack Library,qiskit-community/qiskit-vscode,4,2,2,0
Full-stack Library,qiskit-community/qiskit-vscode,5,0,0,0
Full-stack Library,qiskit-community/qiskit-vscode,6,11,8,3
Full-stack Library,qiskit-community/qiskit-vscode,7,133,88,45
Full-stack Library,qiskit-community/qiskit-vscode,8,4,4,0
Full-stack Library,qiskit-community/qiskit-vscode,9,1721,985,736
Full-stack Library,rigetti/rpcq,0,8307,6206,2101
Full-stack Library,rigetti/rpcq,1,2750,2471,279
Full-stack Library,rigetti/rpcq,2,2973,2579,394
Full-stack Library,rigetti/rpcq,3,274,171,103
Full-stack Library,rigetti/rpcq,4,1718,984,734
Full-stack Library,rigetti/rpcq,5,720,528,192
Full-stack Library,rigetti/rpcq,6,10,6,4
Full-stack Library,rigetti/rpcq,7,2,1,1
Full-stack Library,rigetti/rpcq,8,2,1,1
Quantum-Chemistry,SebWouters/CheMPS2,0,132025,131696,329
Quantum-Chemistry,SebWouters/CheMPS2,1,5942,2513,3429
Quantum-Chemistry,SebWouters/CheMPS2,2,90848,88869,1979
Quantum-Chemistry,SebWouters/CheMPS2,3,37526,20963,16563
Quantum-Chemistry,SebWouters/CheMPS2,4,8969,6166,2803
Quantum-Chemistry,SebWouters/CheMPS2,5,220395,36163,184232
Quantum-Chemistry,SebWouters/CheMPS2,6,3882,2572,1310
Quantum-Chemistry,SebWouters/CheMPS2,7,25859,16490,9369
Quantum-Chemistry,SebWouters/CheMPS2,8,44454,24937,19517
Quantum-Chemistry,SebWouters/CheMPS2,9,30041,16206,13835
Simulator,issp-center-dev/HPhi,0,1511823,1150099,361724
Simulator,issp-center-dev/HPhi,1,1306652,624635,682017
Simulator,issp-center-dev/HPhi,2,1981885,1026862,955023
Simulator,issp-center-dev/HPhi,3,113952,52540,61412
Simulator,issp-center-dev/HPhi,4,456108,231051,225057
Simulator,issp-center-dev/HPhi,5,35700,20932,14768
Simulator,issp-center-dev/HPhi,6,554793,281155,273638
Simulator,issp-center-dev/HPhi,7,695094,444740,250354
Simulator,issp-center-dev/HPhi,8,586649,7405,579244
Simulator,issp-center-dev/HPhi,9,33373,32923,450
Simulator,SoftwareQuTech/SimulaQron,0,128270,93993,34277
Simulator,SoftwareQuTech/SimulaQron,1,54125,38948,15177
Simulator,SoftwareQuTech/SimulaQron,2,16978,10818,6160
Simulator,SoftwareQuTech/SimulaQron,3,124373,52996,71377
Simulator,SoftwareQuTech/SimulaQron,4,69799,38121,31678
Simulator,SoftwareQuTech/SimulaQron,5,115768,51673,64095
Simulator,SoftwareQuTech/SimulaQron,6,13120,7740,5380
Simulator,SoftwareQuTech/SimulaQron,7,584,374,210
Simulator,SoftwareQuTech/SimulaQron,8,137455,45655,91800
Simulator,SoftwareQuTech/SimulaQron,9,276,179,97
Cryptography,exaexa/codecrypt,0,8022,7011,1011
Cryptography,exaexa/codecrypt,1,1243,1064,179
Cryptography,exaexa/codecrypt,2,9704,6915,2789
Cryptography,exaexa/codecrypt,3,3574,3035,539
Cryptography,exaexa/codecrypt,4,7497,6477,1020
Cryptography,exaexa/codecrypt,5,4962,1237,3725
Cryptography,exaexa/codecrypt,6,3009,2458,551
Cryptography,exaexa/codecrypt,7,2009,984,1025
Cryptography,exaexa/codecrypt,8,2,1,1
Cryptography,exaexa/codecrypt,9,4384,2278,2106
Quantum-Chemistry,Quantum-Dynamics-Hub/libra-code,0,123455,109587,13868
Quantum-Chemistry,Quantum-Dynamics-Hub/libra-code,1,452752,443638,9114
Quantum-Chemistry,Quantum-Dynamics-Hub/libra-code,2,42202,29129,13073
Quantum-Chemistry,Quantum-Dynamics-Hub/libra-code,3,150149,148353,1796
Quantum-Chemistry,Quantum-Dynamics-Hub/libra-code,4,543187,535592,7595
Quantum-Chemistry,Quantum-Dynamics-Hub/libra-code,5,146578,144253,2325
Quantum-Chemistry,Quantum-Dynamics-Hub/libra-code,6,683406,671433,11973
Quantum-Chemistry,Quantum-Dynamics-Hub/libra-code,7,3726,3689,37
Quantum-Chemistry,Quantum-Dynamics-Hub/libra-code,8,112584,104263,8321
Quantum-Chemistry,Quantum-Dynamics-Hub/libra-code,9,14688,12679,2009
Quantum Annealing,shinmorino/sqaod,0,24569,18471,6098
Quantum Annealing,shinmorino/sqaod,1,50261,31211,19050
Quantum Annealing,shinmorino/sqaod,2,9196,7153,2043
Quantum Annealing,shinmorino/sqaod,3,6989,5193,1796
Quantum Annealing,shinmorino/sqaod,4,8,1,7
Quantum Annealing,shinmorino/sqaod,5,4,2,2
Quantum Annealing,shinmorino/sqaod,6,2,1,1
Quantum Annealing,shinmorino/sqaod,7,18,13,5
Quantum Annealing,shinmorino/sqaod,8,4,4,0
Quantum Annealing,shinmorino/sqaod,9,4,2,2
Simulator,QuantumBFS/Yao.jl,0,77675,48134,29541
Simulator,QuantumBFS/Yao.jl,1,13413,5402,8011
Simulator,QuantumBFS/Yao.jl,2,8887,3690,5197
Simulator,QuantumBFS/Yao.jl,3,21117,10010,11107
Simulator,QuantumBFS/Yao.jl,4,2033,371,1662
Simulator,QuantumBFS/Yao.jl,5,728,390,338
Simulator,QuantumBFS/Yao.jl,6,14132,1962,12170
Simulator,QuantumBFS/Yao.jl,7,23,15,8
Simulator,QuantumBFS/Yao.jl,8,2,1,1
Simulator,QuantumBFS/Yao.jl,9,2,1,1
ToolKit,TRIQS/triqs,0,104641,88118,16523
ToolKit,TRIQS/triqs,1,11806,6623,5183
ToolKit,TRIQS/triqs,2,8234,6010,2224
ToolKit,TRIQS/triqs,3,24807,14273,10534
ToolKit,TRIQS/triqs,4,15784,8940,6844
ToolKit,TRIQS/triqs,5,8118,4627,3491
ToolKit,TRIQS/triqs,6,4948,2857,2091
ToolKit,TRIQS/triqs,7,33821,32510,1311
ToolKit,TRIQS/triqs,8,4068,2872,1196
ToolKit,TRIQS/triqs,9,25593,7882,17711
Simulator,Strilanc/Quirk,0,6313,4309,2004
Simulator,Strilanc/Quirk,1,116772,68461,48311
Simulator,Strilanc/Quirk,2,50610,21154,29456
Simulator,Strilanc/Quirk,3,3925,1957,1968
Simulator,Strilanc/Quirk,4,5675,3655,2020
Simulator,Strilanc/Quirk,5,47745,28122,19623
Simulator,Strilanc/Quirk,6,8957,6079,2878
Simulator,Strilanc/Quirk,7,26323,15515,10808
Simulator,Strilanc/Quirk,8,6305,4442,1863
Simulator,Strilanc/Quirk,9,10370,7403,2967
Experimentation,sedabull/quantum-shell,0,3748,2634,1114
Experimentation,sedabull/quantum-shell,1,1385,915,470
Experimentation,sedabull/quantum-shell,2,10,5,5
Experimentation,sedabull/quantum-shell,3,2,1,1
Full-stack Library,ProjectQ-Framework/ProjectQ,0,37360,26845,10515
Full-stack Library,ProjectQ-Framework/ProjectQ,1,6238,5330,908
Full-stack Library,ProjectQ-Framework/ProjectQ,2,3759,3300,459
Full-stack Library,ProjectQ-Framework/ProjectQ,3,1695,1121,574
Full-stack Library,ProjectQ-Framework/ProjectQ,4,9043,7926,1117
Full-stack Library,ProjectQ-Framework/ProjectQ,5,2274,2227,47
Full-stack Library,ProjectQ-Framework/ProjectQ,6,790,644,146
Full-stack Library,ProjectQ-Framework/ProjectQ,7,508,500,8
Full-stack Library,ProjectQ-Framework/ProjectQ,8,2077,1769,308
Full-stack Library,ProjectQ-Framework/ProjectQ,9,7400,5777,1623
Simulator,Qiskit/qiskit-aer,0,110571,90453,20118
Simulator,Qiskit/qiskit-aer,1,60198,25614,34584
Simulator,Qiskit/qiskit-aer,2,36743,24497,12246
Simulator,Qiskit/qiskit-aer,3,11159,8696,2463
Simulator,Qiskit/qiskit-aer,4,20396,14513,5883
Simulator,Qiskit/qiskit-aer,5,46579,26401,20178
Simulator,Qiskit/qiskit-aer,6,21509,9800,11709
Simulator,Qiskit/qiskit-aer,7,50598,12135,38463
Simulator,Qiskit/qiskit-aer,8,2,1,1
Simulator,Qiskit/qiskit-aer,9,26,13,13
Full-stack Library,QuantumPackage/qp2,0,867885,726739,141146
Full-stack Library,QuantumPackage/qp2,1,97984,89084,8900
Full-stack Library,QuantumPackage/qp2,2,7785,3602,4183
Full-stack Library,QuantumPackage/qp2,3,728,626,102
Full-stack Library,QuantumPackage/qp2,4,66,22,44
Full-stack Library,QuantumPackage/qp2,5,4,2,2
Full-stack Library,QuantumPackage/qp2,6,0,0,0
Quantum Algorithsm,quantumlib/OpenFermion,0,163264,92855,70409
Quantum Algorithsm,quantumlib/OpenFermion,1,15470,10993,4477
Quantum Algorithsm,quantumlib/OpenFermion,2,16942,12446,4496
Quantum Algorithsm,quantumlib/OpenFermion,3,7612,5599,2013
Quantum Algorithsm,quantumlib/OpenFermion,4,1119,901,218
Quantum Algorithsm,quantumlib/OpenFermion,5,989,926,63
Quantum Algorithsm,quantumlib/OpenFermion,6,1641,1508,133
Quantum Algorithsm,quantumlib/OpenFermion,7,479,453,26
Quantum Algorithsm,quantumlib/OpenFermion,8,958,921,37
Quantum Algorithsm,quantumlib/OpenFermion,9,8324,6663,1661
Full-stack Library,XanaduAI/strawberryfields,0,46093,44105,1988
Full-stack Library,XanaduAI/strawberryfields,1,11452,8993,2459
Full-stack Library,XanaduAI/strawberryfields,2,1069,732,337
Full-stack Library,XanaduAI/strawberryfields,3,56481,32090,24391
Full-stack Library,XanaduAI/strawberryfields,4,16307,10041,6266
Full-stack Library,XanaduAI/strawberryfields,5,19941,13307,6634
Full-stack Library,XanaduAI/strawberryfields,6,21040,10868,10172
Full-stack Library,XanaduAI/strawberryfields,7,30061,20533,9528
Full-stack Library,XanaduAI/strawberryfields,8,28861,11742,17119
Full-stack Library,XanaduAI/strawberryfields,9,44,43,1
Simulator,qutip/qutip,0,29503,19431,10072
Simulator,qutip/qutip,1,33493,24833,8660
Simulator,qutip/qutip,2,29022,18680,10342
Simulator,qutip/qutip,3,23799,14925,8874
Simulator,qutip/qutip,4,24559,10639,13920
Simulator,qutip/qutip,5,11351,6717,4634
Simulator,qutip/qutip,6,28244,12822,15422
Simulator,qutip/qutip,7,43640,32848,10792
Simulator,qutip/qutip,8,28385,18455,9930
Simulator,qutip/qutip,9,77810,39242,38568
ToolKit,jcmgray/quimb,0,9993,6707,3286
ToolKit,jcmgray/quimb,1,8678,5173,3505
ToolKit,jcmgray/quimb,2,4725,2766,1959
ToolKit,jcmgray/quimb,3,4138,2765,1373
ToolKit,jcmgray/quimb,4,781,529,252
ToolKit,jcmgray/quimb,5,2485,1992,493
ToolKit,jcmgray/quimb,6,9580,6521,3059
ToolKit,jcmgray/quimb,7,18921,12992,5929
ToolKit,jcmgray/quimb,8,15907,10786,5121
ToolKit,jcmgray/quimb,9,19956,14066,5890
Quantum-Chemistry,QMCPACK/qmcpack,0,12873,8154,4719
Quantum-Chemistry,QMCPACK/qmcpack,1,21434,17010,4424
Quantum-Chemistry,QMCPACK/qmcpack,2,12711,9487,3224
Quantum-Chemistry,QMCPACK/qmcpack,3,6578,4402,2176
Quantum-Chemistry,QMCPACK/qmcpack,4,95131,92694,2437
Quantum-Chemistry,QMCPACK/qmcpack,5,268716,103352,165364
Quantum-Chemistry,QMCPACK/qmcpack,6,5046,3880,1166
Quantum-Chemistry,QMCPACK/qmcpack,7,17380,12444,4936
Quantum-Chemistry,QMCPACK/qmcpack,8,868941,542063,326878
Quantum-Chemistry,QMCPACK/qmcpack,9,280780,259033,21747
Simulator,QuEST-Kit/QuEST,0,124719,76935,47784
Simulator,QuEST-Kit/QuEST,1,14957,8483,6474
Simulator,QuEST-Kit/QuEST,2,114183,63834,50349
Simulator,QuEST-Kit/QuEST,3,390679,207931,182748
Simulator,QuEST-Kit/QuEST,4,366858,160392,206466
Simulator,QuEST-Kit/QuEST,5,65024,45617,19407
Simulator,QuEST-Kit/QuEST,6,495910,225654,270256
Simulator,QuEST-Kit/QuEST,7,70330,47057,23273
Simulator,QuEST-Kit/QuEST,8,73297,37928,35369
Simulator,QuEST-Kit/QuEST,9,21040,19788,1252
Compiler,QE-Lab/OpenQL,0,128914,127845,1069
Compiler,QE-Lab/OpenQL,1,11932,7347,4585
Compiler,QE-Lab/OpenQL,2,118623,88492,30131
Compiler,QE-Lab/OpenQL,3,12617,8774,3843
Compiler,QE-Lab/OpenQL,4,25746,16691,9055
Compiler,QE-Lab/OpenQL,5,23356,16882,6474
Compiler,QE-Lab/OpenQL,6,55568,29484,26084
Compiler,QE-Lab/OpenQL,7,15567,10928,4639
Compiler,QE-Lab/OpenQL,8,680585,662719,17866
Compiler,QE-Lab/OpenQL,9,607072,102814,504258
ToolKit,deepchem/deepchem,0,16578,9515,7063
ToolKit,deepchem/deepchem,1,336111,191666,144445
ToolKit,deepchem/deepchem,2,59382,50683,8699
ToolKit,deepchem/deepchem,3,21496,11536,9960
ToolKit,deepchem/deepchem,4,120943,74755,46188
ToolKit,deepchem/deepchem,5,174316,118410,55906
ToolKit,deepchem/deepchem,6,60025,52697,7328
ToolKit,deepchem/deepchem,7,100054,68852,31202
ToolKit,deepchem/deepchem,8,73436,25559,47877
ToolKit,deepchem/deepchem,9,556584,299060,257524
ToolKit,aiidateam/aiida-quantumespresso,0,856844,855546,1298
ToolKit,aiidateam/aiida-quantumespresso,1,39231,26732,12499
ToolKit,aiidateam/aiida-quantumespresso,2,81487,80150,1337
ToolKit,aiidateam/aiida-quantumespresso,3,6208,3197,3011
ToolKit,aiidateam/aiida-quantumespresso,4,20512,19672,840
ToolKit,aiidateam/aiida-quantumespresso,5,7816,6124,1692
ToolKit,aiidateam/aiida-quantumespresso,6,35266,33472,1794
ToolKit,aiidateam/aiida-quantumespresso,7,912816,11252,901564
ToolKit,aiidateam/aiida-quantumespresso,8,119912,74757,45155
ToolKit,aiidateam/aiida-quantumespresso,9,49785,9148,40637
Quantum Algorithsm,rigetti/grove,0,11357,7793,3564
Quantum Algorithsm,rigetti/grove,1,2444,1484,960
Quantum Algorithsm,rigetti/grove,2,4348,3408,940
Quantum Algorithsm,rigetti/grove,3,24254,15054,9200
Quantum Algorithsm,rigetti/grove,4,987,846,141
Quantum Algorithsm,rigetti/grove,5,1593,1192,401
Quantum Algorithsm,rigetti/grove,6,154,87,67
Quantum Algorithsm,rigetti/grove,7,190,105,85
Quantum Algorithsm,rigetti/grove,8,716,378,338
Quantum Algorithsm,rigetti/grove,9,663,352,311
Simulator,vm6502q/qrack,0,161105,94889,66216
Simulator,vm6502q/qrack,1,37688,21884,15804
Simulator,vm6502q/qrack,2,11846,7412,4434
Simulator,vm6502q/qrack,3,19589,12358,7231
Simulator,vm6502q/qrack,4,4933,2979,1954
Simulator,vm6502q/qrack,5,16140,9913,6227
Simulator,vm6502q/qrack,6,16328,11544,4784
Simulator,vm6502q/qrack,7,3411,2200,1211
Simulator,vm6502q/qrack,8,12606,7510,5096
Simulator,vm6502q/qrack,9,9751,6555,3196
ToolKit,XanaduAI/pennylane,0,6718,5871,847
ToolKit,XanaduAI/pennylane,1,252421,144970,107451
ToolKit,XanaduAI/pennylane,2,80752,52053,28699
ToolKit,XanaduAI/pennylane,3,6407,4677,1730
ToolKit,XanaduAI/pennylane,4,15395,9767,5628
ToolKit,XanaduAI/pennylane,5,48389,25299,23090
ToolKit,XanaduAI/pennylane,6,93976,68126,25850
ToolKit,XanaduAI/pennylane,7,35145,23014,12131
ToolKit,XanaduAI/pennylane,8,28894,23196,5698
ToolKit,XanaduAI/pennylane,9,243,121,122
Quantum Algorithsm,netket/netket,0,538738,477902,60836
Quantum Algorithsm,netket/netket,1,226260,16218,210042
Quantum Algorithsm,netket/netket,2,2261953,1144081,1117872
Quantum Algorithsm,netket/netket,3,19580,12810,6770
Quantum Algorithsm,netket/netket,4,65416,24540,40876
Quantum Algorithsm,netket/netket,5,32762,15503,17259
Quantum Algorithsm,netket/netket,6,16478,7601,8877
Quantum Algorithsm,netket/netket,7,7573,4601,2972
Quantum Algorithsm,netket/netket,8,45,29,16
Quantum Algorithsm,netket/netket,9,0,0,0
Quantum Algorithsm,XanaduAI/thewalrus,0,20503,17151,3352
Quantum Algorithsm,XanaduAI/thewalrus,1,35209,34121,1088
Quantum Algorithsm,XanaduAI/thewalrus,2,120818,84976,35842
Quantum Algorithsm,XanaduAI/thewalrus,3,1250910,925462,325448
Quantum Algorithsm,XanaduAI/thewalrus,4,715340,49182,666158
Quantum Algorithsm,XanaduAI/thewalrus,5,8202,4780,3422
Quantum Algorithsm,XanaduAI/thewalrus,6,3132,1634,1498
Quantum Algorithsm,XanaduAI/thewalrus,7,2,1,1
Quantum Algorithsm,XanaduAI/thewalrus,8,3306,1778,1528
Quantum-Chemistry,cp2k/cp2k,0,149935,130316,19619
Quantum-Chemistry,cp2k/cp2k,1,13943,9492,4451
Quantum-Chemistry,cp2k/cp2k,2,156087,110479,45608
Quantum-Chemistry,cp2k/cp2k,3,76883,54213,22670
Quantum-Chemistry,cp2k/cp2k,4,254891,228869,26022
Quantum-Chemistry,cp2k/cp2k,5,109124,45624,63500
Quantum-Chemistry,cp2k/cp2k,6,52476,38820,13656
Quantum-Chemistry,cp2k/cp2k,7,83117,66988,16129
Quantum-Chemistry,cp2k/cp2k,8,86553,57627,28926
Quantum-Chemistry,cp2k/cp2k,9,155229,87127,68102
Simulator,qulacs/qulacs,0,48161,38332,9829
Simulator,qulacs/qulacs,1,2499,2020,479
Simulator,qulacs/qulacs,2,21081,13065,8016
Simulator,qulacs/qulacs,3,24301,18755,5546
Simulator,qulacs/qulacs,4,9260,4253,5007
Simulator,qulacs/qulacs,5,3159,2538,621
Simulator,qulacs/qulacs,6,0,0,0
Simulator,qulacs/qulacs,7,83,55,28
Simulator,qulacs/qulacs,8,0,0,0
Simulator,qulacs/qulacs,9,8,4,4
Quantum-Chemistry,votca/xtp,0,5006,4879,127
Quantum-Chemistry,votca/xtp,1,300,123,177
Quantum-Chemistry,votca/xtp,2,1590,916,674
Quantum-Chemistry,votca/xtp,3,71,34,37
Quantum-Chemistry,votca/xtp,4,6278,4427,1851
Quantum-Chemistry,votca/xtp,5,15045,7849,7196
Quantum-Chemistry,votca/xtp,6,5181,2883,2298
Quantum-Chemistry,votca/xtp,7,1575,1032,543
Quantum-Chemistry,votca/xtp,8,1953,1061,892
Quantum-Chemistry,votca/xtp,9,66866,65750,1116
ToolKit,OriginQ/QPanda-2,0,43228,32029,11199
ToolKit,OriginQ/QPanda-2,1,355513,287907,67606
ToolKit,OriginQ/QPanda-2,2,190024,167978,22046
ToolKit,OriginQ/QPanda-2,3,15245,9147,6098
ToolKit,OriginQ/QPanda-2,4,113698,83493,30205
ToolKit,OriginQ/QPanda-2,5,16652,10479,6173
ToolKit,OriginQ/QPanda-2,6,126601,121864,4737
ToolKit,OriginQ/QPanda-2,7,14,7,7
ToolKit,OriginQ/QPanda-2,8,30996,17704,13292
ToolKit,OriginQ/QPanda-2,9,0,0,0
Full-stack Library,Blueqat/Blueqat,0,6891,5570,1321
Full-stack Library,Blueqat/Blueqat,1,19603,12800,6803
Full-stack Library,Blueqat/Blueqat,2,15707,6441,9266
Full-stack Library,Blueqat/Blueqat,3,3584,2190,1394
Full-stack Library,Blueqat/Blueqat,4,455,335,120
Full-stack Library,Blueqat/Blueqat,5,1037,765,272
Full-stack Library,Blueqat/Blueqat,6,2361,1475,886
Full-stack Library,Blueqat/Blueqat,7,83,81,2
Full-stack Library,Blueqat/Blueqat,8,13,8,5
Full-stack Library,Blueqat/Blueqat,9,2,2,0
Quantum Algorithsm,qucontrol/krotov,0,31446,24370,7076
Quantum Algorithsm,qucontrol/krotov,1,27933,18361,9572
Quantum Algorithsm,qucontrol/krotov,2,1274,828,446
Quantum Algorithsm,qucontrol/krotov,3,8953,6087,2866
Quantum Algorithsm,qucontrol/krotov,4,6190,3887,2303
Quantum Algorithsm,qucontrol/krotov,5,2695,1714,981
Quantum Algorithsm,qucontrol/krotov,6,2,1,1
Quantum Algorithsm,qucontrol/krotov,7,13,8,5
Quantum Algorithsm,qucontrol/krotov,8,0,0,0
Quantum Algorithsm,qucontrol/krotov,9,124,62,62
Experimentation,iitis/QuantumInformation.jl,0,2227,1548,679
Experimentation,iitis/QuantumInformation.jl,1,1203,892,311
Experimentation,iitis/QuantumInformation.jl,2,118,60,58
Experimentation,iitis/QuantumInformation.jl,3,47,42,5
Experimentation,iitis/QuantumInformation.jl,4,16,13,3
Experimentation,iitis/QuantumInformation.jl,5,23,9,14
Experimentation,iitis/QuantumInformation.jl,6,4,3,1
Experimentation,iitis/QuantumInformation.jl,7,5108,3347,1761
Experimentation,iitis/QuantumInformation.jl,8,6301,4450,1851
Experimentation,iitis/QuantumInformation.jl,9,2673,1049,1624
Experimentation,qutech/qupulse,0,210,210,0
Experimentation,qutech/qupulse,1,18819,13201,5618
Experimentation,qutech/qupulse,2,11703,6550,5153
Experimentation,qutech/qupulse,3,3283,2918,365
Experimentation,qutech/qupulse,4,21720,19090,2630
Experimentation,qutech/qupulse,5,4415,3722,693
Experimentation,qutech/qupulse,6,6137,4090,2047
Experimentation,qutech/qupulse,7,11550,7048,4502
Experimentation,qutech/qupulse,8,10851,6438,4413
Experimentation,qutech/qupulse,9,27753,18672,9081
Full-stack Library,quantumlib/Cirq,0,33540,26423,7117
Full-stack Library,quantumlib/Cirq,1,24183,18926,5257
Full-stack Library,quantumlib/Cirq,2,46608,32522,14086
Full-stack Library,quantumlib/Cirq,3,44941,29583,15358
Full-stack Library,quantumlib/Cirq,4,27171,20679,6492
Full-stack Library,quantumlib/Cirq,5,26370,21353,5017
Full-stack Library,quantumlib/Cirq,6,54327,40745,13582
Full-stack Library,quantumlib/Cirq,7,44647,32214,12433
Full-stack Library,quantumlib/Cirq,8,65052,42920,22132
Full-stack Library,quantumlib/Cirq,9,21638,15906,5732
Quantum-Chemistry,hande-qmc/hande,0,25474,22915,2559
Quantum-Chemistry,hande-qmc/hande,1,123284,63736,59548
Quantum-Chemistry,hande-qmc/hande,2,28354,15017,13337
Quantum-Chemistry,hande-qmc/hande,3,73651,47699,25952
Quantum-Chemistry,hande-qmc/hande,4,341,98,243
Quantum-Chemistry,hande-qmc/hande,5,2491,1920,571
Quantum-Chemistry,hande-qmc/hande,6,5165,4485,680
Quantum-Chemistry,hande-qmc/hande,7,10479,7541,2938
Quantum-Chemistry,hande-qmc/hande,8,50365,30748,19617
Quantum-Chemistry,hande-qmc/hande,9,485215,451079,34136
Quantum Algorithsm,aeantipov/pomerol,0,20175,15515,4660
Quantum Algorithsm,aeantipov/pomerol,1,245,214,31
Quantum Algorithsm,aeantipov/pomerol,2,7790,5870,1920
Quantum Algorithsm,aeantipov/pomerol,3,38909,29711,9198
Quantum Algorithsm,aeantipov/pomerol,4,2262,1611,651
Quantum Algorithsm,aeantipov/pomerol,5,22501,12985,9516
Quantum Algorithsm,aeantipov/pomerol,6,31435,9888,21547
Quantum Algorithsm,aeantipov/pomerol,7,3542,2285,1257
Quantum Algorithsm,aeantipov/pomerol,8,2535,553,1982
Quantum Algorithsm,aeantipov/pomerol,9,2796,1614,1182
Experimentation,BBN-Q/QGL,0,5594,4154,1440
Experimentation,BBN-Q/QGL,1,3477,2126,1351
Experimentation,BBN-Q/QGL,2,788,565,223
Experimentation,BBN-Q/QGL,3,784,524,260
Experimentation,BBN-Q/QGL,4,1821,1255,566
Experimentation,BBN-Q/QGL,5,997,583,414
Experimentation,BBN-Q/QGL,6,481,286,195
Experimentation,BBN-Q/QGL,7,1160,755,405
Experimentation,BBN-Q/QGL,8,2838,1492,1346
Experimentation,BBN-Q/QGL,9,2652,626,2026
Quantum Algorithsm,Q-solvers/EDLib,0,36142,20115,16027
Quantum Algorithsm,Q-solvers/EDLib,1,5559,3171,2388
Quantum Algorithsm,Q-solvers/EDLib,2,527,352,175
Quantum Algorithsm,Q-solvers/EDLib,3,3241,2506,735
Quantum Algorithsm,Q-solvers/EDLib,4,1629,1316,313
Quantum Algorithsm,Q-solvers/EDLib,5,401,223,178
Quantum Algorithsm,Q-solvers/EDLib,6,944,921,23
Quantum Algorithsm,Q-solvers/EDLib,7,139,85,54
Quantum Algorithsm,Q-solvers/EDLib,8,6,2,4
Quantum Algorithsm,Q-solvers/EDLib,9,91,41,50
Assembly,lanl/qmasm,0,5268,3576,1692
Assembly,lanl/qmasm,1,3757,2638,1119
Assembly,lanl/qmasm,2,1987,1333,654
Assembly,lanl/qmasm,3,2083,1375,708
Assembly,lanl/qmasm,4,542,347,195
Assembly,lanl/qmasm,5,539,507,32
Assembly,lanl/qmasm,6,1382,927,455
Assembly,lanl/qmasm,7,304,242,62
Assembly,lanl/qmasm,8,1389,907,482
Assembly,lanl/qmasm,9,1146,791,355
Quantum-Chemistry,tmancal74/quantarhei,0,121355,89628,31727
Quantum-Chemistry,tmancal74/quantarhei,1,56309,41333,14976
Quantum-Chemistry,tmancal74/quantarhei,2,5274,4924,350
Quantum-Chemistry,tmancal74/quantarhei,3,18611,13238,5373
Quantum-Chemistry,tmancal74/quantarhei,4,20249,12795,7454
Quantum-Chemistry,tmancal74/quantarhei,5,326195,186785,139410
Quantum-Chemistry,tmancal74/quantarhei,6,19856,16777,3079
Quantum-Chemistry,tmancal74/quantarhei,7,9222,6398,2824
Quantum-Chemistry,tmancal74/quantarhei,8,26651,24583,2068
Quantum-Chemistry,tmancal74/quantarhei,9,17222,11955,5267
ToolKit,bloomberg/quantum,0,88796,85968,2828
ToolKit,bloomberg/quantum,1,21840,17599,4241
ToolKit,bloomberg/quantum,2,43967,23742,20225
ToolKit,bloomberg/quantum,3,5342,3837,1505
ToolKit,bloomberg/quantum,4,3041,1966,1075
ToolKit,bloomberg/quantum,5,13,7,6
ToolKit,bloomberg/quantum,6,3104,2460,644
ToolKit,bloomberg/quantum,7,2026,1385,641
ToolKit,bloomberg/quantum,8,235,210,25
ToolKit,bloomberg/quantum,9,0,0,0
ToolKit,rigetti/forest-benchmarking,0,28756,23642,5114
ToolKit,rigetti/forest-benchmarking,1,30638,21280,9358
ToolKit,rigetti/forest-benchmarking,2,24568,13618,10950
ToolKit,rigetti/forest-benchmarking,3,63,50,13
ToolKit,rigetti/forest-benchmarking,4,2,1,1
ToolKit,rigetti/forest-benchmarking,5,7,5,2
ToolKit,rigetti/forest-benchmarking,6,505,285,220
ToolKit,rigetti/forest-benchmarking,7,14,12,2
ToolKit,rigetti/forest-benchmarking,8,496,232,264
ToolKit,rigetti/forest-benchmarking,9,1,0,1
Quantum-Chemistry,LCPQ/quantum_package,0,765957,582138,183819
Quantum-Chemistry,LCPQ/quantum_package,1,197080,99518,97562
Quantum-Chemistry,LCPQ/quantum_package,2,172019,108179,63840
Quantum-Chemistry,LCPQ/quantum_package,3,439336,18735,420601
Quantum-Chemistry,LCPQ/quantum_package,4,73947,44017,29930
Quantum-Chemistry,LCPQ/quantum_package,5,20669,11321,9348
Quantum-Chemistry,LCPQ/quantum_package,6,771671,763917,7754
Quantum-Chemistry,LCPQ/quantum_package,7,850928,841743,9185
Quantum-Chemistry,LCPQ/quantum_package,8,18932,14335,4597
Quantum-Chemistry,LCPQ/quantum_package,9,42686,29506,13180
Quantum-Chemistry,vonDonnerstein/QuantumLab.jl,0,4565,3492,1073
Quantum-Chemistry,vonDonnerstein/QuantumLab.jl,1,2431,897,1534
Quantum-Chemistry,vonDonnerstein/QuantumLab.jl,2,7611,5410,2201
Quantum-Chemistry,vonDonnerstein/QuantumLab.jl,3,1872,961,911
Quantum-Chemistry,vonDonnerstein/QuantumLab.jl,4,198,114,84
Quantum-Chemistry,vonDonnerstein/QuantumLab.jl,5,200,84,116
Quantum-Chemistry,vonDonnerstein/QuantumLab.jl,6,1312,791,521
Quantum-Chemistry,vonDonnerstein/QuantumLab.jl,7,120,119,1
Quantum-Chemistry,vonDonnerstein/QuantumLab.jl,8,123,43,80
Quantum-Chemistry,vonDonnerstein/QuantumLab.jl,9,220,124,96
ToolKit,QuTech-Delft/qtt,0,22598,18144,4454
ToolKit,QuTech-Delft/qtt,1,89829,57759,32070
ToolKit,QuTech-Delft/qtt,2,17041,10429,6612
ToolKit,QuTech-Delft/qtt,3,20520,14835,5685
ToolKit,QuTech-Delft/qtt,4,15601,8337,7264
ToolKit,QuTech-Delft/qtt,5,6170,2826,3344
ToolKit,QuTech-Delft/qtt,6,7108,4567,2541
ToolKit,QuTech-Delft/qtt,7,8386,4238,4148
ToolKit,QuTech-Delft/qtt,8,609292,604953,4339
ToolKit,QuTech-Delft/qtt,9,3093915,3077835,16080
Experimentation,lneuhaus/pyrpl,0,166111,108833,57278
Experimentation,lneuhaus/pyrpl,1,593667,578589,15078
Experimentation,lneuhaus/pyrpl,2,663497,66005,597492
Experimentation,lneuhaus/pyrpl,3,142211,66286,75925
Experimentation,lneuhaus/pyrpl,4,31242,17908,13334
Experimentation,lneuhaus/pyrpl,5,40419,25798,14621
Experimentation,lneuhaus/pyrpl,6,33,24,9
Experimentation,lneuhaus/pyrpl,7,170,91,79
Experimentation,lneuhaus/pyrpl,8,7,7,0
Experimentation,lneuhaus/pyrpl,9,36,36,0
Simulator,quantumlib/OpenFermion-Cirq,0,10046,8178,1868
Simulator,quantumlib/OpenFermion-Cirq,1,47612,30153,17459
Simulator,quantumlib/OpenFermion-Cirq,2,9772,4713,5059
Simulator,quantumlib/OpenFermion-Cirq,3,1177,828,349
Simulator,quantumlib/OpenFermion-Cirq,4,2701,1772,929
Simulator,quantumlib/OpenFermion-Cirq,5,80,54,26
Simulator,quantumlib/OpenFermion-Cirq,6,7180,3218,3962
Simulator,quantumlib/OpenFermion-Cirq,7,7225,5811,1414
Simulator,quantumlib/OpenFermion-Cirq,8,1042,1030,12
Simulator,quantumlib/OpenFermion-Cirq,9,436,9,427
Quantum Algorithsm,dwave-examples/factoring,0,4343,2721,1622
Quantum Algorithsm,dwave-examples/factoring,1,1374,652,722
Quantum Algorithsm,dwave-examples/factoring,2,29,14,15
Quantum Algorithsm,dwave-examples/factoring,3,3,3,0
Quantum Algorithsm,dwave-examples/factoring,4,604,123,481
Quantum Algorithsm,dwave-examples/factoring,5,350,243,107
Quantum Algorithsm,dwave-examples/factoring,6,445,238,207
Quantum Algorithsm,dwave-examples/factoring,7,12,9,3
Quantum Algorithsm,dwave-examples/factoring,8,0,0,0
Quantum Algorithsm,dwave-examples/factoring,9,68,23,45
ToolKit,lmacken/quantumrandom,0,1219,911,308
ToolKit,lmacken/quantumrandom,1,22,16,6
ToolKit,lmacken/quantumrandom,2,335,285,50
ToolKit,lmacken/quantumrandom,3,55,42,13
ToolKit,lmacken/quantumrandom,4,2,1,1
ToolKit,QInfer/python-qinfer,0,5063,3952,1111
ToolKit,QInfer/python-qinfer,1,12450,8481,3969
ToolKit,QInfer/python-qinfer,2,1480,1169,311
ToolKit,QInfer/python-qinfer,3,77,67,10
ToolKit,QInfer/python-qinfer,4,1040,881,159
ToolKit,QInfer/python-qinfer,5,3463,3151,312
ToolKit,QInfer/python-qinfer,6,1613,1422,191
ToolKit,QInfer/python-qinfer,7,1707,1564,143
ToolKit,QInfer/python-qinfer,8,1426,1118,308
ToolKit,QInfer/python-qinfer,9,1568,1312,256
ToolKit,zoran-cuckovic/QGIS-visibility-analysis,0,8624,7254,1370
ToolKit,zoran-cuckovic/QGIS-visibility-analysis,1,2219,1435,784
ToolKit,zoran-cuckovic/QGIS-visibility-analysis,2,834,584,250
ToolKit,zoran-cuckovic/QGIS-visibility-analysis,3,989,519,470
ToolKit,zoran-cuckovic/QGIS-visibility-analysis,4,9546,4110,5436
ToolKit,zoran-cuckovic/QGIS-visibility-analysis,5,510,125,385
ToolKit,zoran-cuckovic/QGIS-visibility-analysis,6,5,3,2
ToolKit,zoran-cuckovic/QGIS-visibility-analysis,7,0,0,0
ToolKit,zoran-cuckovic/QGIS-visibility-analysis,8,225,225,0
ToolKit,zoran-cuckovic/QGIS-visibility-analysis,9,204,204,0
Simulator,microsoft/qmt,0,25365,24822,543
Simulator,microsoft/qmt,1,69633,59071,10562
Simulator,microsoft/qmt,2,63365,24457,38908
Simulator,microsoft/qmt,3,2862,1974,888
Simulator,microsoft/qmt,4,66637,8601,58036
Simulator,microsoft/qmt,5,72,26,46
Simulator,microsoft/qmt,6,513,242,271
Simulator,microsoft/qmt,7,0,0,0
Simulator,microsoft/qmt,8,15,15,0
Simulator,microsoft/qmt,9,38,32,6
Simulator,Approximates/dotBloch,0,74720,42050,32670
Simulator,Approximates/dotBloch,1,702,495,207
Simulator,Approximates/dotBloch,2,7547,5711,1836
Simulator,Approximates/dotBloch,3,16477,11453,5024
Simulator,Approximates/dotBloch,4,6259,5142,1117
Simulator,Approximates/dotBloch,5,242,240,2
Simulator,Approximates/dotBloch,6,196,43,153
Simulator,Approximates/dotBloch,7,427,351,76
Simulator,Approximates/dotBloch,8,61,60,1
ToolKit,qucat/qucat,0,24595,13868,10727
ToolKit,qucat/qucat,1,542290,316053,226237
ToolKit,qucat/qucat,2,27830,15737,12093
ToolKit,qucat/qucat,3,136922,74651,62271
ToolKit,qucat/qucat,4,305951,213674,92277
ToolKit,Qiskit/qiskit-ignis,0,3173,2959,214
ToolKit,Qiskit/qiskit-ignis,1,4375,2900,1475
ToolKit,Qiskit/qiskit-ignis,2,43987,24320,19667
ToolKit,Qiskit/qiskit-ignis,3,332228,167775,164453
ToolKit,Qiskit/qiskit-ignis,4,9052,6888,2164
ToolKit,Qiskit/qiskit-ignis,5,6907,4513,2394
ToolKit,Qiskit/qiskit-ignis,6,11633,7449,4184
ToolKit,Qiskit/qiskit-ignis,7,5630,2927,2703
ToolKit,Qiskit/qiskit-ignis,8,83,70,13
ToolKit,Qiskit/qiskit-ignis,9,32,32,0
Quantum Algorithsm,PanPalitta/phase_estimation,0,9229,6942,2287
Quantum Algorithsm,PanPalitta/phase_estimation,1,1306,846,460
Quantum Algorithsm,PanPalitta/phase_estimation,2,79873,41436,38437
Quantum Algorithsm,PanPalitta/phase_estimation,3,2725,1498,1227
Quantum Algorithsm,PanPalitta/phase_estimation,4,1800,592,1208
Quantum Algorithsm,PanPalitta/phase_estimation,5,149,74,75
Quantum Algorithsm,PanPalitta/phase_estimation,6,77,52,25
Quantum Algorithsm,PanPalitta/phase_estimation,7,254,157,97
Quantum Algorithsm,ProjectQ-Framework/FermiLib,0,21081,18294,2787
Quantum Algorithsm,ProjectQ-Framework/FermiLib,1,2,1,1
Quantum Algorithsm,ProjectQ-Framework/FermiLib,2,1844,1843,1
Quantum Algorithsm,ProjectQ-Framework/FermiLib,3,164,88,76
Quantum Algorithsm,ProjectQ-Framework/FermiLib,4,17,1,16
Quantum Algorithsm,ProjectQ-Framework/FermiLib,5,757,757,0
Quantum Algorithsm,ProjectQ-Framework/FermiLib,6,5,1,4
Quantum Algorithsm,ProjectQ-Framework/FermiLib,7,5,0,5
Quantum Algorithsm,ProjectQ-Framework/FermiLib,8,31,17,14
Quantum Algorithsm,ProjectQ-Framework/FermiLib,9,124,110,14
Assembly,XanaduAI/blackbird,0,41173,31574,9599
Assembly,XanaduAI/blackbird,1,14438,9548,4890
Assembly,XanaduAI/blackbird,2,470,306,164
Assembly,XanaduAI/blackbird,3,1238,635,603
Assembly,XanaduAI/blackbird,4,4388,2532,1856
Assembly,XanaduAI/blackbird,5,505,237,268
Full-stack Library,softwareQinc/staq,0,130637,117082,13555
Full-stack Library,softwareQinc/staq,1,729432,727630,1802
Full-stack Library,softwareQinc/staq,2,435881,34625,401256
Full-stack Library,softwareQinc/staq,3,148660,82474,66186
Full-stack Library,softwareQinc/staq,4,51,41,10
Full-stack Library,softwareQinc/staq,5,2,1,1
Full-stack Library,softwareQinc/staq,6,21,12,9
Full-stack Library,softwareQinc/staq,7,11,11,0
Full-stack Library,softwareQinc/staq,8,23,8,15
Full-stack Library,softwareQinc/staq,9,10,5,5
Quantum-Chemistry,ericchansen/q2mm,0,6377,5276,1101
Quantum-Chemistry,ericchansen/q2mm,1,7794,4692,3102
Quantum-Chemistry,ericchansen/q2mm,2,13320,7099,6221
Quantum-Chemistry,ericchansen/q2mm,3,1966,1163,803
Quantum-Chemistry,ericchansen/q2mm,4,6717,3484,3233
Quantum-Chemistry,ericchansen/q2mm,5,2896,1964,932
Quantum-Chemistry,ericchansen/q2mm,6,1139,836,303
Quantum-Chemistry,ericchansen/q2mm,7,151633,97673,53960
Quantum-Chemistry,ericchansen/q2mm,8,103801,95634,8167
Quantum-Chemistry,ericchansen/q2mm,9,32572,32313,259
Quantum-Chemistry,aoterodelaroza/critic2,0,866507,855040,11467
Quantum-Chemistry,aoterodelaroza/critic2,1,20480,13708,6772
Quantum-Chemistry,aoterodelaroza/critic2,2,9275,7072,2203
Quantum-Chemistry,aoterodelaroza/critic2,3,7149,4680,2469
Quantum-Chemistry,aoterodelaroza/critic2,4,10370,5968,4402
Quantum-Chemistry,aoterodelaroza/critic2,5,80870,75743,5127
Quantum-Chemistry,aoterodelaroza/critic2,6,87479,46920,40559
Quantum-Chemistry,aoterodelaroza/critic2,7,27952,18315,9637
Quantum-Chemistry,aoterodelaroza/critic2,8,265366,167543,97823
Quantum-Chemistry,aoterodelaroza/critic2,9,4936,2858,2078
ToolKit,orbkit/orbkit,0,37728,29383,8345
ToolKit,orbkit/orbkit,1,5435,3524,1911
ToolKit,orbkit/orbkit,2,18091,14072,4019
ToolKit,orbkit/orbkit,3,746,622,124
ToolKit,orbkit/orbkit,4,10272,6617,3655
ToolKit,orbkit/orbkit,5,10757,7817,2940
ToolKit,orbkit/orbkit,6,59400,27702,31698
ToolKit,orbkit/orbkit,7,8727,6077,2650
ToolKit,orbkit/orbkit,8,926,648,278
ToolKit,orbkit/orbkit,9,3128,2255,873
Quantum Algorithsm,JoshuaSBrown/QC_Tools,0,2583,2364,219
Quantum Algorithsm,JoshuaSBrown/QC_Tools,1,41,38,3
Quantum Algorithsm,JoshuaSBrown/QC_Tools,2,344,174,170
Quantum Algorithsm,JoshuaSBrown/QC_Tools,3,4250,2630,1620
Quantum Algorithsm,JoshuaSBrown/QC_Tools,4,15678,10689,4989
Quantum Algorithsm,JoshuaSBrown/QC_Tools,5,1957,1107,850
Quantum Algorithsm,JoshuaSBrown/QC_Tools,6,241,152,89
Quantum Algorithsm,JoshuaSBrown/QC_Tools,7,11780,5835,5945
Quantum Algorithsm,JoshuaSBrown/QC_Tools,8,69,62,7
Quantum Algorithsm,JoshuaSBrown/QC_Tools,9,6,3,3
Experimentation,zlatko-minev/pyEPR,0,5076,4483,593
Experimentation,zlatko-minev/pyEPR,1,110,85,25
Experimentation,zlatko-minev/pyEPR,2,1281,1016,265
Experimentation,zlatko-minev/pyEPR,3,2479,1917,562
Experimentation,zlatko-minev/pyEPR,4,5111,3561,1550
Experimentation,zlatko-minev/pyEPR,5,32613,21158,11455
Experimentation,zlatko-minev/pyEPR,6,862,648,214
Experimentation,zlatko-minev/pyEPR,7,169,165,4
Experimentation,zlatko-minev/pyEPR,8,13,11,2
Experimentation,zlatko-minev/pyEPR,9,2,1,1
Simulator,Qiskit/qiskit-jku-provider,0,16042,13159,2883
Simulator,Qiskit/qiskit-jku-provider,1,741,501,240
Simulator,Qiskit/qiskit-jku-provider,2,1235,921,314
Simulator,Qiskit/qiskit-jku-provider,3,4,2,2
Simulator,Qiskit/qiskit-jku-provider,4,3,2,1
Simulator,Qiskit/qiskit-jku-provider,5,2,1,1
Simulator,Qiskit/qiskit-jku-provider,6,2,1,1
Simulator,Qiskit/qiskit-jku-provider,7,0,0,0
Simulator,Qiskit/qiskit-jku-provider,8,0,0,0
Simulator,Qiskit/qiskit-jku-provider,9,18,9,9
Compiler,Quantomatic/pyzx,0,838737,578940,259797
Compiler,Quantomatic/pyzx,1,1779052,1241740,537312
Compiler,Quantomatic/pyzx,2,437559,182631,254928
Compiler,Quantomatic/pyzx,3,96893,66566,30327
Compiler,Quantomatic/pyzx,4,219289,116948,102341
Compiler,Quantomatic/pyzx,5,22835,17173,5662
Compiler,Quantomatic/pyzx,6,1247468,1169471,77997
Compiler,Quantomatic/pyzx,7,9059,8124,935
Compiler,Quantomatic/pyzx,8,194,129,65
Compiler,Quantomatic/pyzx,9,44,22,22
Quantum-Chemistry,GQCG/GQCP,0,241739,231468,10271
Quantum-Chemistry,GQCG/GQCP,1,49872,36360,13512
Quantum-Chemistry,GQCG/GQCP,2,520663,264232,256431
Quantum-Chemistry,GQCG/GQCP,3,56518,27310,29208
Quantum-Chemistry,GQCG/GQCP,4,24652,14276,10376
Quantum-Chemistry,GQCG/GQCP,5,43617,23588,20029
Quantum-Chemistry,GQCG/GQCP,6,48351,30597,17754
Quantum-Chemistry,GQCG/GQCP,7,155150,145407,9743
Quantum-Chemistry,GQCG/GQCP,8,103,61,42
Quantum-Chemistry,GQCG/GQCP,9,431,215,216
ToolKit,qubekit/QUBEKit,0,160960,122341,38619
ToolKit,qubekit/QUBEKit,1,24544,10470,14074
ToolKit,qubekit/QUBEKit,2,30802,19207,11595
ToolKit,qubekit/QUBEKit,3,16275,6692,9583
ToolKit,qubekit/QUBEKit,4,4383,2387,1996
ToolKit,qubekit/QUBEKit,5,4806,2721,2085
ToolKit,qubekit/QUBEKit,6,1834,893,941
ToolKit,qubekit/QUBEKit,7,6,3,3
ToolKit,qubekit/QUBEKit,8,154,59,95
ToolKit,qubekit/QUBEKit,9,0,0,0
ToolKit,tensorflow/quantum,0,112693,75932,36761
ToolKit,tensorflow/quantum,1,5150,4371,779
ToolKit,tensorflow/quantum,2,6,3,3
ToolKit,tensorflow/quantum,3,3,1,2
ToolKit,tensorflow/quantum,4,16,8,8
ToolKit,tensorflow/quantum,5,135,100,35
ToolKit,tensorflow/quantum,6,12,6,6
ToolKit,tensorflow/quantum,7,4,4,0
ToolKit,tensorflow/quantum,8,297,240,57
ToolKit,tensorflow/quantum,9,313,308,5
ToolKit,redhat-cip/openstack-quantum-puppet,0,3273,2097,1176
ToolKit,redhat-cip/openstack-quantum-puppet,1,316,214,102
ToolKit,redhat-cip/openstack-quantum-puppet,2,200,189,11
ToolKit,redhat-cip/openstack-quantum-puppet,3,125,84,41
ToolKit,redhat-cip/openstack-quantum-puppet,4,50,42,8
ToolKit,redhat-cip/openstack-quantum-puppet,5,69,34,35
ToolKit,redhat-cip/openstack-quantum-puppet,6,2,1,1
ToolKit,redhat-cip/openstack-quantum-puppet,7,55,38,17
ToolKit,redhat-cip/openstack-quantum-puppet,8,8,4,4
ToolKit,redhat-cip/openstack-quantum-puppet,9,6,3,3
Simulator,arguelles/nuSQuIDS,0,633095,575678,57417
Simulator,arguelles/nuSQuIDS,1,133241,70635,62606
Simulator,arguelles/nuSQuIDS,2,12122,6185,5937
Simulator,arguelles/nuSQuIDS,3,3012,851,2161
Simulator,arguelles/nuSQuIDS,4,5684,3996,1688
Simulator,arguelles/nuSQuIDS,5,15688,14457,1231
Simulator,arguelles/nuSQuIDS,6,31202,30435,767
Simulator,arguelles/nuSQuIDS,7,838,514,324
Simulator,arguelles/nuSQuIDS,8,1043,712,331
Simulator,arguelles/nuSQuIDS,9,903,520,383
Quantum Algorithsm,qrefine/qrefine,0,2503780,2336332,167448
Quantum Algorithsm,qrefine/qrefine,1,1919,1412,507
Quantum Algorithsm,qrefine/qrefine,2,8921,7036,1885
Quantum Algorithsm,qrefine/qrefine,3,2884,2280,604
Quantum Algorithsm,qrefine/qrefine,4,392447,382402,10045
Quantum Algorithsm,qrefine/qrefine,5,2943,2382,561
Quantum Algorithsm,qrefine/qrefine,6,7186,4878,2308
Quantum Algorithsm,qrefine/qrefine,7,331,258,73
Quantum Algorithsm,qrefine/qrefine,8,402,260,142
Quantum Algorithsm,qrefine/qrefine,9,480,287,193
Quantum-Chemistry,qcdb/qcdb,0,1383986,1378850,5136
Quantum-Chemistry,qcdb/qcdb,1,69,57,12
Quantum-Chemistry,qcdb/qcdb,2,53334,18861,34473
Quantum-Chemistry,qcdb/qcdb,3,7234,3670,3564
Quantum-Chemistry,qcdb/qcdb,4,14870,8627,6243
Quantum-Chemistry,qcdb/qcdb,5,23425,10456,12969
Quantum-Chemistry,qcdb/qcdb,6,797,593,204
Quantum-Chemistry,qcdb/qcdb,7,0,0,0
Quantum-Chemistry,qcdb/qcdb,8,101,74,27
Quantum-Chemistry,qcdb/qcdb,9,98,25,73
Cryptography,mupq/pqm4,0,36696,34595,2101
Cryptography,mupq/pqm4,1,2410,2384,26
Cryptography,mupq/pqm4,2,153839,152725,1114
Cryptography,mupq/pqm4,3,142028,9511,132517
Cryptography,mupq/pqm4,4,194524,181578,12946
Cryptography,mupq/pqm4,5,19273,14248,5025
Cryptography,mupq/pqm4,6,14681,8040,6641
Cryptography,mupq/pqm4,7,77468,71761,5707
Cryptography,mupq/pqm4,8,2700,1462,1238
Cryptography,mupq/pqm4,9,192,102,90
ToolKit,boschmitt/tweedledum,0,251369,249847,1522
Simulator,ngnrsaa/qflex,0,152206,116353,35853
Simulator,ngnrsaa/qflex,1,10188,5695,4493
Simulator,ngnrsaa/qflex,2,66781,33328,33453
Simulator,ngnrsaa/qflex,3,13301,10499,2802
Simulator,ngnrsaa/qflex,4,11221,10700,521
Simulator,ngnrsaa/qflex,5,3264,3264,0
Simulator,ngnrsaa/qflex,6,0,0,0
Simulator,ngnrsaa/qflex,7,2,1,1
Simulator,ngnrsaa/qflex,8,2,1,1
Simulator,ngnrsaa/qflex,9,7,6,1
Experimentation,BBN-Q/Qlab,0,54247,53683,564
Experimentation,BBN-Q/Qlab,1,15064,12851,2213
Experimentation,BBN-Q/Qlab,2,8874,7388,1486
Experimentation,BBN-Q/Qlab,3,24155,11761,12394
Experimentation,BBN-Q/Qlab,4,41154,25866,15288
Experimentation,BBN-Q/Qlab,5,44658,21281,23377
Experimentation,BBN-Q/Qlab,6,38232,16009,22223
Experimentation,BBN-Q/Qlab,7,60310,30505,29805
Experimentation,BBN-Q/Qlab,8,33064,16194,16870
Experimentation,BBN-Q/Qlab,9,34855,14997,19858
Experimentation,BBN-Q/PyQLab,0,2226,1860,366
Experimentation,BBN-Q/PyQLab,1,3842,2440,1402
Experimentation,BBN-Q/PyQLab,2,514,370,144
Experimentation,BBN-Q/PyQLab,3,7305,4892,2413
Experimentation,BBN-Q/PyQLab,4,11207,6316,4891
Experimentation,BBN-Q/PyQLab,5,768,530,238
Experimentation,BBN-Q/PyQLab,6,1458,984,474
Experimentation,BBN-Q/PyQLab,7,3456,1902,1554
Experimentation,BBN-Q/PyQLab,8,2217,1524,693
Experimentation,BBN-Q/PyQLab,9,1444,884,560
Assembly,BBN-Q/pyqgl2,0,10496,8064,2432
Assembly,BBN-Q/pyqgl2,1,22622,17573,5049
Assembly,BBN-Q/pyqgl2,2,16706,10659,6047
Assembly,BBN-Q/pyqgl2,3,17469,10858,6611
Assembly,BBN-Q/pyqgl2,4,774,88,686
Assembly,BBN-Q/pyqgl2,5,9891,4115,5776
Assembly,BBN-Q/pyqgl2,6,18,9,9
Assembly,BBN-Q/pyqgl2,7,277,140,137
Assembly,BBN-Q/pyqgl2,8,826,562,264
Assembly,BBN-Q/pyqgl2,9,4474,2265,2209
Assembly,artiste-qb-net/qubiter,0,19866,13592,6274
Assembly,artiste-qb-net/qubiter,1,7985,2132,5853
Assembly,artiste-qb-net/qubiter,2,12881,10594,2287
Assembly,artiste-qb-net/qubiter,3,19280,17327,1953
Assembly,artiste-qb-net/qubiter,4,10267,7277,2990
Assembly,artiste-qb-net/qubiter,5,21243,11822,9421
Assembly,artiste-qb-net/qubiter,6,4700,3243,1457
Assembly,artiste-qb-net/qubiter,7,7826,5267,2559
Assembly,artiste-qb-net/qubiter,8,24975,18483,6492
Assembly,artiste-qb-net/qubiter,9,295938,189703,106235
Assembly,BBN-Q/QGL.jl,0,3322,2684,638
Assembly,BBN-Q/QGL.jl,1,782,571,211
Assembly,BBN-Q/QGL.jl,2,176,89,87
Assembly,BBN-Q/QGL.jl,3,134,112,22
Assembly,BBN-Q/QGL.jl,4,2,2,0
Assembly,BBN-Q/QGL.jl,5,4,2,2
Assembly,BBN-Q/QGL.jl,6,8,4,4
Assembly,BBN-Q/QGL.jl,7,22,21,1
Assembly,BBN-Q/QGL.jl,8,11,6,5
Assembly,BBN-Q/QGL.jl,9,95,39,56
Quantum Annealing,dwavesystems/qbsolv,0,4697558,4693315,4243
Quantum Annealing,dwavesystems/qbsolv,1,209970,206867,3103
Quantum Annealing,dwavesystems/qbsolv,2,16879,9546,7333
Quantum Annealing,dwavesystems/qbsolv,3,19379,10190,9189
Quantum Annealing,dwavesystems/qbsolv,4,735,515,220
Quantum Annealing,dwavesystems/qbsolv,5,4794,3176,1618
Quantum Annealing,dwavesystems/qbsolv,6,63,54,9
Quantum Annealing,dwavesystems/qbsolv,7,8,4,4
Quantum Annealing,dwavesystems/qbsolv,8,125,74,51
Quantum Annealing,dwavesystems/qbsolv,9,2,1,1
Quantum Annealing,dwavesystems/dimod,0,7082,5447,1635
Quantum Annealing,dwavesystems/dimod,1,10308,6761,3547
Quantum Annealing,dwavesystems/dimod,2,21338,12506,8832
Quantum Annealing,dwavesystems/dimod,3,5054,3455,1599
Quantum Annealing,dwavesystems/dimod,4,14182,9183,4999
Quantum Annealing,dwavesystems/dimod,5,7922,3943,3979
Quantum Annealing,dwavesystems/dimod,6,12979,9497,3482
Quantum Annealing,dwavesystems/dimod,7,2843,2164,679
Quantum Annealing,dwavesystems/dimod,8,2501,1880,621
Quantum Annealing,dwavesystems/dimod,9,1661,1227,434
Quantum Annealing,dwavesystems/dwave-system,0,4589,4588,1
Quantum Annealing,dwavesystems/dwave-system,1,328,248,80
Quantum Annealing,dwavesystems/dwave-system,2,4,2,2
Quantum Annealing,dwavesystems/dwave-system,3,1830,1495,335
Quantum Annealing,dwavesystems/dwave-system,4,10793,6694,4099
Quantum Annealing,dwavesystems/dwave-system,5,3063,2117,946
Quantum Annealing,dwavesystems/dwave-system,6,1480,1118,362
Quantum Annealing,dwavesystems/dwave-system,7,10119,5019,5100
Quantum Annealing,dwavesystems/dwave-system,8,2602,1725,877
Quantum Annealing,dwavesystems/dwave-system,9,4473,2416,2057
Quantum Annealing,dwavesystems/dwavebinarycsp,0,2339,2008,331
Quantum Annealing,dwavesystems/dwavebinarycsp,1,7685,5301,2384
Quantum Annealing,dwavesystems/dwavebinarycsp,2,1292,1139,153
Quantum Annealing,dwavesystems/dwavebinarycsp,3,108,66,42
Quantum Annealing,dwavesystems/dwavebinarycsp,4,148,92,56
Quantum Annealing,dwavesystems/dwavebinarycsp,5,3,2,1
Quantum Annealing,dwavesystems/dwavebinarycsp,6,106,55,51
Quantum Annealing,dwavesystems/dwavebinarycsp,7,555,161,394
Quantum Annealing,dwavesystems/dwavebinarycsp,8,0,0,0
Quantum Annealing,dwavesystems/penaltymodel,0,18201,12562,5639
Quantum Annealing,dwavesystems/penaltymodel,1,4023,1290,2733
Quantum Annealing,dwavesystems/penaltymodel,2,2670,1845,825
Quantum Annealing,dwavesystems/penaltymodel,3,130,103,27
Quantum Annealing,dwavesystems/penaltymodel,4,3037,1798,1239
Quantum Annealing,dwavesystems/penaltymodel,5,477,369,108
Quantum Annealing,dwavesystems/penaltymodel,6,320,318,2
Quantum Annealing,dwavesystems/penaltymodel,7,88,66,22
Quantum Annealing,dwavesystems/penaltymodel,8,601,348,253
Quantum Annealing,dwavesystems/penaltymodel,9,6,3,3
Simulator,aparent/QCViewer,0,430729,350955,79774
Simulator,aparent/QCViewer,1,6623,3517,3106
Simulator,aparent/QCViewer,2,13355,7961,5394
Simulator,aparent/QCViewer,3,18419,14402,4017
Simulator,aparent/QCViewer,4,2279,1277,1002
Simulator,aparent/QCViewer,5,8356,6640,1716
Simulator,aparent/QCViewer,6,21811,15394,6417
Simulator,aparent/QCViewer,7,14023,13116,907
Simulator,aparent/QCViewer,8,69,25,44
Simulator,aparent/QCViewer,9,16,7,9
